########################
#P   #     # V #C   #  G
# # ### # ### ## ## # ##
# #     #     #   # #  #
# ##### # # # ### # ## #
# #   # ####  #     #  #
#   #  E   # ## # # # ##
# ### ### ##  ### # #  #
#   #     #   #   # ## #
# # ##### # # # ### #  #
# #           #   # # ##
# ########### ### #    #
#C#E         V    ## # #
######################## 