########################
#P                     #
#                      #
#   #######    #####   #
#                      #
#     #          E     #
#     #    #####       #
#     #                #
#            #         G
#   #####    #    ######
#            #         #
#            #         #
#                      #
########################