########################
#P #       #           #
#  # ##### # #E  #  E###
#  #     # # #       # #
#  ##### # # # ####### #
#      # # # #     # # #
# #### # #   # ##### # #
# #  # # #####         #
# #  # #     #    # ####
# # ## ##### # V  #    #
# #      E # #    #### #
########## #  #####  # #
#                    # G
########################